Novel of size 1: +word_boundary	#
Novel of size 1: -word_boundary	J,S,Z,a,aa,b,c,d,dZ,dz,e,ee,f,g,gy,h,i,ii,j,k,l,m,n,o,oe,oo,ooe,p,r,s,t,tS,ts,u,uu,v,y,yy,z
Novel of size 3: -high,+back,+long	aa,oo
Novel of size 2: -low,-long	e,i,o,oe,u,y
Novel of size 2: +consonantal,+sonorant	J,l,m,n,r
Novel of size 3: -high,-low,+long	ee,oo,ooe
Novel of size 3: -high,-low,-round	e,ee
Novel of size 1: -syllabic	J,S,Z,b,c,d,dZ,dz,f,g,gy,h,j,k,l,m,n,p,r,s,t,tS,ts,v,z
Novel of size 1: +long	aa,ee,ii,oo,ooe,uu,yy
Novel of size 2: -high,-long	a,e,o,oe
Novel of size 2: +del_rel,+voice	dZ,dz
Novel of size 1: -round	a,aa,e,ee,i,ii
Novel of size 2: +del_rel,+anterior	dz,ts
Novel of size 2: -voice,-anterior	S,c,tS
Novel of size 3: +high,-low,+back	u,uu
Novel of size 2: -continuant,+coronal	c,d,dZ,dz,gy,t,tS,ts
Novel of size 1: +labial	b,f,m,p,v
Novel of size 1: -coronal	J,g,k
Novel of size 2: -back,-long	e,i,oe,y
Novel of size 2: -approximant,+coronal	S,Z,c,d,dZ,dz,gy,n,s,t,tS,ts,z
Novel of size 2: -del_rel,+voice	b,d,g,gy
Novel of size 2: +low,+long	aa
Novel of size 3: +high,-round,+long	ii
Novel of size 4: +high,-back,+round,+long	yy
Novel of size 2: +high,-back	i,ii,y,yy
Novel of size 1: -voice	S,c,f,h,k,p,s,t,tS,ts
Novel of size 2: -high,+long	aa,ee,oo,ooe
Novel of size 2: +round,+long	oo,ooe,uu,yy
Novel of size 3: -high,-back,+long	ee,ooe
Novel of size 2: -approximant,+sonorant	J,m,n
Novel of size 1: +anterior	d,dz,l,n,r,s,t,ts,z
Novel of size 2: -sonorant,+dorsal	c,g,gy,k
Novel of size 2: -continuant,-anterior	c,dZ,gy,tS
Novel of size 2: -continuant,+voice	b,d,dZ,dz,g,gy
Novel of size 3: +consonantal,+continuant,-voice	S,f,s
Novel of size 2: -del_rel,+coronal	c,d,gy,t
Novel of size 2: -round,-long	a,e,i
Novel of size 1: -high	a,aa,e,ee,o,oe,oo,ooe
Novel of size 2: +consonantal,-sonorant	S,Z,b,c,d,dZ,dz,f,g,gy,k,p,s,t,tS,ts,v,z
Novel of size 2: +round,-long	o,oe,u,y
Novel of size 1: +consonantal	J,S,Z,b,c,d,dZ,dz,f,g,gy,k,l,m,n,p,r,s,t,tS,ts,v,z
Novel of size 2: +voice,+coronal	Z,d,dZ,dz,gy,z
Novel of size 2: +high,-low	i,ii,u,uu,y,yy
Novel of size 1: -consonantal	a,aa,e,ee,h,i,ii,j,o,oe,oo,ooe,u,uu,y,yy
Novel of size 3: -high,-back,-long	e,oe
Novel of size 3: +high,-back,+long	ii,yy
Novel of size 2: +back,-long	a,o,u
Novel of size 3: -high,+round,-long	o,oe
Novel of size 2: +approximant,-syllabic	j,l,r
Novel of size 2: -approximant,+anterior	d,dz,n,s,t,ts,z
Novel of size 2: +sonorant,-coronal	J
Novel of size 2: +continuant,+voice	Z,v,z
Novel of size 2: +sonorant,+coronal	l,n,r
Novel of size 1: +back	a,aa,j,o,oo,u,uu
Novel of size 3: -high,-low,+back	o,oo
Novel of size 3: -back,+round,-long	oe,y
Novel of size 3: +continuant,-voice,-anterior	S
Novel of size 2: -del_rel,-anterior	c,gy
Novel of size 2: +consonantal,-approximant	J,S,Z,b,c,d,dZ,dz,f,g,gy,k,m,n,p,s,t,tS,ts,v,z
Novel of size 3: -del_rel,+voice,+coronal	d,gy
Novel of size 2: +high,-long	i,u,y
Novel of size 1: +round	o,oe,oo,ooe,u,uu,y,yy
Novel of size 2: +voice,+dorsal	g,gy
Novel of size 3: +continuant,+voice,-anterior	Z
Novel of size 3: -high,-back,+round	oe,ooe
Novel of size 3: +del_rel,-voice,-anterior	tS
Novel of size 2: -high,-back	e,ee,oe,ooe
Novel of size 2: +low,-long	a
Novel of size 1: -long	a,e,i,o,oe,u,y
Novel of size 3: -continuant,+voice,+labial	b
Novel of size 3: -continuant,+voice,+coronal	d,dZ,dz,gy
Novel of size 3: -del_rel,-voice,-anterior	c
Novel of size 2: -low,+back	o,oo,u,uu
Novel of size 2: -back,+long	ee,ii,ooe,yy
Novel of size 3: -del_rel,+voice,+anterior	d
Novel of size 3: -high,+round,+long	oo,ooe
Novel of size 1: +syllabic	a,aa,e,ee,i,ii,o,oe,oo,ooe,u,uu,y,yy
Novel of size 4: -high,-low,-round,-long	e
Novel of size 2: -voice,+anterior	s,t,ts
Novel of size 3: +continuant,-voice,+labial	f
Novel of size 2: +voice,-coronal	g
Novel of size 1: +spread	h
Novel of size 3: -continuant,+voice,-anterior	dZ,gy
Novel of size 3: +high,-round,-long	i
Novel of size 2: +high,-syllabic	j
Novel of size 2: -voice,-coronal	k
Novel of size 1: +lateral	l
Novel of size 2: +sonorant,+labial	m
Novel of size 2: +sonorant,-syllabic	J,j,l,m,n,r
Novel of size 3: -approximant,+sonorant,+coronal	n
Novel of size 4: -high,-low,+back,-long	o
Novel of size 3: -continuant,-voice,+labial	p
Novel of size 1: +dorsal	J,c,g,gy,k
Novel of size 1: -lateral	r
Novel of size 3: +continuant,-voice,+anterior	s
Novel of size 2: +voice,+anterior	d,dz,z
Novel of size 3: -del_rel,-voice,+anterior	t
Novel of size 1: +voice	Z,b,d,dZ,dz,g,gy,v,z
Novel of size 3: +high,+back,-long	u
Novel of size 2: +consonantal,+continuant	S,Z,f,s,v,z
Novel of size 3: +continuant,+voice,+labial	v
Novel of size 3: +del_rel,+voice,-anterior	dZ
Novel of size 4: +high,-back,+round,-long	y
Novel of size 3: +continuant,+voice,+anterior	z
Novel of size 2: -voice,+coronal	S,c,s,t,tS,ts
Novel of size 2: +high,+back	j,u,uu
Novel of size 3: +del_rel,-voice,+anterior	ts
Novel of size 3: -low,+back,+long	oo,uu
Novel of size 1: +low	a,aa
Novel of size 1: -back	e,ee,i,ii,oe,ooe,y,yy
Novel of size 4: -high,-back,+round,+long	ooe
Novel of size 2: -high,-round	a,aa,e,ee
Novel of size 2: +high,-round	i,ii
Novel of size 2: -low,-round	e,ee,i,ii
Novel of size 2: -continuant,-voice	c,k,p,t,tS,ts
Novel of size 2: +continuant,-voice	S,f,h,s
Novel of size 3: +del_rel,+voice,+anterior	dz
Novel of size 1: -sonorant	S,Z,b,c,d,dZ,dz,f,g,gy,h,k,p,s,t,tS,ts,v,z
Novel of size 3: +high,-back,+round	y,yy
Novel of size 2: +continuant,+coronal	S,Z,s,z
Novel of size 2: +back,+long	aa,oo,uu
Novel of size 3: +high,+back,+long	uu
Novel of size 4: -high,-low,-round,+long	ee
Novel of size 1: +high	i,ii,j,u,uu,y,yy
Novel of size 3: -back,+round,+long	ooe,yy
Novel of size 3: -high,-low,-long	e,o,oe
Novel of size 2: -high,+round	o,oe,oo,ooe
Novel of size 1: +approximant	a,aa,e,ee,i,ii,j,l,o,oe,oo,ooe,r,u,uu,y,yy
Novel of size 2: +continuant,-anterior	S,Z
Novel of size 2: -sonorant,+labial	b,f,p,v
Novel of size 2: +high,+round	u,uu,y,yy
Novel of size 2: -high,-low	e,ee,o,oe,oo,ooe
Novel of size 2: -sonorant,+coronal	S,Z,c,d,dZ,dz,gy,s,t,tS,ts,z
Novel of size 2: -del_rel,-voice	c,k,p,t
Novel of size 3: -continuant,-voice,+coronal	c,t,tS,ts
Novel of size 1: -continuant	b,c,d,dZ,dz,g,gy,k,p,t,tS,ts
Novel of size 2: +consonantal,-voice	S,c,f,k,p,s,t,tS,ts
Novel of size 1: -approximant	J,S,Z,b,c,d,dZ,dz,f,g,gy,h,k,m,n,p,s,t,tS,ts,v,z
Novel of size 3: +high,+round,+long	uu,yy
Novel of size 3: -high,-round,+long	aa,ee
Novel of size 3: -low,-round,+long	ee,ii
Novel of size 2: +voice,-anterior	Z,dZ,gy
Novel of size 3: -continuant,-voice,-anterior	c,tS
Novel of size 3: +continuant,-voice,+coronal	S,s
Novel of size 3: -high,-round,-long	a,e
Novel of size 2: -voice,+dorsal	c,k
Novel of size 3: -low,-round,-long	e,i
Novel of size 2: -high,+back	a,aa,o,oo
Novel of size 3: -high,+back,-long	a,o
Novel of size 1: -del_rel	b,c,d,g,gy,k,p,t
Novel of size 2: -consonantal,-syllabic	h,j
Novel of size 2: -sonorant,-coronal	g,k
Novel of size 2: -continuant,+labial	b,p
Novel of size 2: -consonantal,+approximant	a,aa,e,ee,i,ii,j,o,oe,oo,ooe,u,uu,y,yy
Novel of size 3: +continuant,+voice,+coronal	Z,z
Novel of size 2: +del_rel,-anterior	dZ,tS
Novel of size 1: +sonorant	J,a,aa,e,ee,i,ii,j,l,m,n,o,oe,oo,ooe,r,u,uu,y,yy
Novel of size 2: -voice,+labial	f,p
Novel of size 4: -high,-back,+round,-long	oe
Novel of size 1: -anterior	S,Z,c,dZ,gy,tS
Novel of size 3: -del_rel,-voice,+coronal	c,t
Novel of size 2: -del_rel,+anterior	d,t
Novel of size 2: +voice,+labial	b,v
Novel of size 2: -sonorant,+anterior	d,dz,s,t,ts,z
Novel of size 2: +continuant,+labial	f,v
Novel of size 1: +continuant	S,Z,f,h,s,v,z
Novel of size 2: +consonantal,+approximant	l,r
Novel of size 2: +del_rel,-voice	tS,ts
Novel of size 2: +high,+long	ii,uu,yy
Novel of size 2: -round,+long	aa,ee,ii
Novel of size 4: -high,-low,+back,+long	oo
Novel of size 3: +high,-back,-long	i,y
Novel of size 1: -low	e,ee,i,ii,o,oe,oo,ooe,u,uu,y,yy
Novel of size 2: -low,+long	ee,ii,oo,ooe,uu,yy
Novel of size 3: -low,+back,-long	o,u
Novel of size 2: +back,+syllabic	a,aa,o,oo,u,uu
Novel of size 1: +del_rel	dZ,dz,tS,ts
Novel of size 2: +continuant,+anterior	s,z
Novel of size 2: -continuant,+anterior	d,dz,t,ts
Novel of size 3: +high,+round,-long	u,y
Novel of size 3: -del_rel,+voice,-anterior	gy
Novel of size 3: -continuant,-voice,+anterior	t,ts
Novel of size 2: -back,+round	oe,ooe,y,yy
Novel of size 3: -continuant,+voice,+anterior	d,dz
Novel of size 1: +coronal	S,Z,c,d,dZ,dz,gy,l,n,r,s,t,tS,ts,z
